################
#P1............F1#
#..##..#..##...#
#..##..#..##.G.#
#..............#
#..F2#####..##..#
#..............#
#..##..#..##...#
#..##..#..##...#
#G.....#.....P2.#
################
