############
#P1........F1#
#..##.#.##.#
#G....#....#
#######.####
#.........G#
#..##.#.##.#
#F2...#....P2#
############
