####################
#P1............F2....#
#.####.##.####.#####
#...................
#.####.##..###.#####
#....F1.. ...G.......
#.###.##.#.####.###
#G............P2....#
####################