##########
#P1..#....#
#......F2.#
#..#.#...#
#..#G#...#
#..#.#...#
#..#.#..F1#
#..#.#..G.#
#.......P2#
##########